#########################
#......................o#
#......................o#
#.######.###.###.######.#
 }#    #.#  M  #.#    #. 
 .#    #.#######.#    #. 
#.######.........######.#
#o.....................o#
#o...................?.o#
#########################