################################
#o{...........................o#
#M............................o#
#.######.##..........##.######.#
 .#    #.##.###  ###.##.#    #. 
 .#    #.##.#  MM  #.##.#    #. 
#.######.##.########.##.######.#
#o............................o#
#o............................o#
################################
