###################
#..#.#....#..#... #
#...o..o...#...#.##
 }oo.oo.#.###..... 
#.................#
#.................#
################### 
