#################################
#o.............................o#
#{oM...........................o#
#.######.##...........##.######.#
 .#    #.##.###   ###.##.#    #. 
 .#    #.##.#       #.##.#    #. 
#.######.##.#########.##.######.#
#o.............................o#
#o.................M...........o#
#################################
