################################
#o.............................#
#.............................o#
#.######.##..........##.######.#
 }#    #.##.###  ###.##.#    #. 
 .#    #.##.#      #.##.#    #. 
#.######.##.########.##.######.#
#o............................o#
#..............................#
############.###################
